drakaesh = { 
	59 31 24 107 106 105 104 103 29 22
	27 23 25 6 7 72 69 68 53 65
	2347 83 81 82 87 77 71 78 73 67
	79 85 94 93 92 91 61 561 562 2399
	70 110 109 108 96 95 97 99 101 102
	100 98 89 90 88 86 84 80 74 75
	66 64 57 58 56 55 60 62 63 54
	52 76 32 14 3 5 26 4 2 33
	15 21 1 9 8 28 16 13 47 49
	169 201 202 203 204 205 206 207 208 209
	210 211 212 213 214 215 216 217 218 219
	220 221 222 223 224 225 226 227 170 171
	172 173 174 175 176 177 178 179 180 181
	182 183 184 185 186 187 188 189 190 191
	192 193 194 195 196 197 198 332 333 334
	335 336 337 338 339 340 341 342 343 344
	345 346 347 348 349 350 351 352 353 354
	355 356 357 358 359 360 361 364 34 35
	36 37 38 39 40 41 42 43 44 45
	46 48 50 51 10 11 12 20 17 19
	30 18 
}
north_astios = { 
}
south_astios = { 
}
katsura = { 
}
elaresh = { 
}
phormyrr = { 
	953 954 955 956 957 958 959 960 961 962
	963 964 965 966 967 968 969 970 971 1008
	1009 1010 1011 1012 1013 1014 1015 1016 1017 1018
	1019 1020 1021 1022 1023 1024 1025 1026 1027 1028
	1029 1030 1031 1032 1033 1034 1035 1036 1037 1038
	1039 1040 1041 1042 1043 1044 1045 1046 1047 1048
	1049 1050 1051 1052 1053 1054 1055 2010 2013 2023
	2553 2554 2555 2556 2557 2558 2559 2560 2561 2562
	2563 2564 2565 2566 2567 2639 4871 4872 4873 4874
	4875 4876 4912 980 981 982 983 984 985 986
	987 988 989 990 991 992 993 994 995 996
	997 1001 1007 1097 1098 1099 1100 1101 1102 1103
	1104 1105 1106 1107 1108 1109 1110 1111 1112 1113
	1114 1115 1116 1117 1118 1119 1120 1121 1122 1123
	1124 1125 1126 1127 1128 1129 1130 2012 2015 2568
	2569 2570 2571 2572 2573 2574 2575 2576 2577 2578
	2579 2580 2581 2582 2583 2584 2585 2586 2587 2670
	2671 4890 4891 4892 4893 4894 4895 4896 4897 926
	927 928 929 930 931 932 933 935 936 937
	938 949 950 952 1131 1132 1133 1134 1135 1136
	1137 1138 1139 1140 1141 1142 1143 1144 1145 1146
	1147 1148 1149 1150 1151 1152 1153 1154 1155 1156
	1157 1158 1159 1160 1161 1162 1163 1164 1165 1166
	1167 1168 1169 1170 1171 1172 1173 1174 1175 1176
	2011 2527 2534 2535 2536 2537 2538 2539 2540 2541
	2542 2543 2544 2545 2546 2547 2548 2549 2550 2552
	4625 4626 4877 4878 4879 4880 4881 4882 910 911
	912 913 914 915 916 917 942 943 944 945
	946 947 948 1056 1057 1058 1059 1060 1061 1062
	1063 1064 1065 1066 1067 1068 1069 1070 1071 1072
	1073 1074 1075 1076 1077 1078 1079 1080 1081 1082
	1083 1084 1085 1086 1087 1088 1089 1090 1091 1092
	1093 1094 1095 1096 2517 2518 2519 2520 2521 2522
	2523 2524 2525 4898 4899 4903 4904 4907 4922 
}
onthukan = { 
}
