drakaesh = { 
	59 107 106 105 104 103 69 68 53 65
	83 81 82 87 77 71 78 73 67 79
	85 94 93 92 91 61 70 110 109 108
	96 95 97 99 101 102 100 98 89 90
	88 86 84 80 74 75 66 64 57 58
	56 55 60 62 63 54 52 76 47 49
	169 201 202 203 204 205 206 207 208 209
	210 211 212 213 214 215 216 217 218 219
	220 221 222 223 224 225 226 227 170 171
	172 173 174 175 176 177 178 179 180 181
	182 183 184 185 186 187 188 189 190 191
	192 193 194 195 196 197 198 34 35 36
	37 38 39 40 41 42 43 44 45 46
	48 50 51 111 112 113 114 115 116 117
	118 119 120 121 122 123 124 125 126 127
	128 129 130 131 132 133 134 135 136 137
	138 139 140 141 143 144 145 146 147 148
	149 150 151 152 153 154 155 156 157 158
	159 160 161 162 163 164 165 166 199 200
	370 373 374 384 385 386 387 388 389 390
	391 392 393 394 395 612 613 2093 2094 2095
	2096 2097 2098 2099 2100 2101 2102 2103 2104 2105
	2106 2107 2108 2109 2110 2111 2112 2113 2114 3000
	3001 3002 4173 4174 4175 4176 4239 4655 4656 4698
	4699 4701 4702 4703 4704 4705 4706 4750 4752 4753
	4754 4755 4756 4757 4779 4780 332 333 334 335
	336 337 338 339 340 341 342 343 344 345
	346 347 348 349 350 351 352 353 354 355
	356 357 358 359 360 361 364 366 371 383
	142 167 168 2059 2060 2061 2062 2063 2064 2065
	2066 2067 2068 2069 2070 2071 2072 2073 2074 2075
	2076 2077 2078 2079 2080 2081 2082 2083 2084 2085
	2086 2087 2088 2089 2090 2091 2092 362 363 365
	367 368 369 372 375 376 377 378 379 380
	381 382 592 593 594 595 596 597 598 599
	600 601 602 603 604 605 606 607 608 609
	610 611 614 2115 2116 2117 2118 2119 2120 2121
	2122 2123 2124 2125 2126 2127 2128 2129 2130 2131
	2132 2133 2134 2135 2136 2137 2138 2139 2140 2141
	2142 2143 2144 2145 2146 2147 2148 2149 2150 2151
	2152 2153 2154 2155 2156 2157 2158 2159 2160 2161
	2162 2163 2164 2165 2166 2167 2168 2169 2170 2171
	2172 2173 2174 2175 2176 2177 2178 2179 2180 2181
	2182 2183 2184 2185 2186 2187 2188 2189 2190 2191
	2192 2193 4366 4369 1 2 3 4 5 6
	7 8 9 10 11 12 13 14 15 16
	17 18 19 20 21 22 23 24 25 26
	27 28 29 30 31 32 33 1844 1845 1846
	1847 1848 1849 1850 1851 1852 1853 1854 1855 1856
	1857 1858 1859 1860 1861 1862 1863 1864 1865 561
	562 563 564 565 566 567 568 569 570 571
	572 573 574 575 576 577 578 579 580 581
	582 583 584 585 586 587 588 589 590 591
	1963 1964 4129 1866 1867 1868 1869 1870 1871 1872
	1873 1874 1875 1876 1877 1878 1879 1880 1881 1882
	1930 1931 1965 1966 1967 1968 1969 1970 1971 1972
	1973 1974 1978 1979 1981 1982 1983 1984 1985 1986
	1987 1988 1989 1990 1991 1992 1993 1994 1995 1996
	1997 1998 1999 2002 2003 2004 2005 2006 2007 2008
	2009 2010 2011 2012 2013 2014 72 2330 2331 2332
	2333 2334 2335 2339 2340 2341 2342 2343 2344 2345
	2346 2347 2348 2349 2350 2351 2352 2353 2354 2355
	2356 2357 2358 2359 2360 2361 2362 2363 2364 2365
	2366 2367 2368 2369 2370 2371 2372 2373 2374 2375
	2376 2377 2378 2379 2380 2381 2382 2383 2384 2385
	2386 2387 2388 2389 2390 2391 2392 2393 2394 2395
	2396 2397 2398 2399 2400 2401 2402 2403 2404 2405
	2406 2407 2408 2409 2410 2411 2412 2413 2414 2415
	2416 2417 2418 2419 2420 2421 2422 2423 2424 2425
	2426 2427 2428 2429 2430 2431 2432 2433 2434 2435
	2436 2336 2337 2338 
}
north_astios = { 
	2194 2195 2196 2197 2198 2199 2200 2201 2202 2203
	2204 2205 2206 2207 2208 2209 2210 2211 2212 2213
	2214 2215 2216 2217 2218 2219 2220 2221 2222 2223
	2224 2225 2226 2227 2228 2229 2230 2231 2232 2233
	2234 2235 2236 2237 2238 2239 2240 2241 2242 2243
	2244 2245 2246 2247 2248 2249 2250 2251 2252 2253
	2254 2255 2256 2257 2258 2259 2260 2261 2262 2263
	2264 2265 2266 2767 2768 2769 2770 2771 2772 2773
	2775 2776 2778 2779 2780 2781 2782 2783 2784 2785
	2786 2787 2788 2789 2790 2791 2792 2793 2794 2795
	2797 2798 2799 4033 4158 1306 2295 2296 2297 2298
	2299 2300 2301 2302 2303 2304 2305 2306 2307 2308
	2309 2310 2311 2312 2313 2314 2315 2316 2317 2318
	2319 2320 2321 2322 2323 2324 2325 2326 2327 2328
	2329 2267 2268 2269 2270 2271 2272 2273 2274 2275
	2276 2277 2278 2279 2280 2281 2282 2283 2284 2285
	2286 2287 2288 2289 2290 2291 2292 2293 2294 2800
	2801 2802 2932 1925 2015 2016 2017 2018 2019 2020
	2021 2022 2023 2024 2025 2026 2027 2029 2030 2031
	2032 2033 2034 2035 2036 2037 2038 2039 2040 2041
	2042 2043 2044 2045 2046 2047 2048 2049 2050 2051
	2052 2053 2054 2055 2056 2057 2058 4053 4054 4055
	4056 4057 4058 4059 4060 4061 4062 4063 4064 4065
	4066 4067 4068 4069 4070 4071 4072 4073 4074 4075
	4076 4077 4089 4090 4094 4095 4096 4097 4098 4099
	4100 4101 4102 4103 4104 4105 4106 4107 4108 4109
	445 684 685 686 687 688 689 690 691 692
	693 694 695 696 697 698 699 700 701 702
	703 704 705 706 707 708 709 710 711 712
	713 714 715 716 717 718 719 720 721 722
	723 724 4268 4269 4272 4273 4274 4275 4277 4278
	4279 4280 4281 4282 4283 4284 4285 4286 4287 1901
	2513 2514 2515 2516 2517 2518 2519 2520 2521 2522
	2523 2524 2526 2527 2528 2529 2530 2531 2532 2533
	2534 2535 2536 2537 2538 2539 2540 2541 2542 2543
	2544 2545 2546 2547 2548 2549 2550 2551 2552 2553
	2554 2555 2556 2557 2558 2559 2560 2561 2562 2563
	2564 2565 2566 2567 2568 2569 2570 2571 2572 2573
	2574 2575 2576 2577 2578 2579 2580 2581 2582 2583
	2584 2585 2765 2948 2949 4078 4079 4080 4081 4082
	4083 4084 4085 4086 4087 4088 4091 4092 4093 2621
	2622 2623 2624 2625 2626 2627 2628 2629 2630 2631
	2632 2633 2634 2635 2636 2637 2638 2639 2640 2641
	2642 2643 2644 2645 4299 4301 4302 4303 4305 4306
	4340 396 397 398 399 400 401 402 403 404
	405 406 407 408 409 410 411 412 413 414
	415 416 417 418 419 420 421 422 423 424
	425 426 427 428 429 430 431 432 433 434
	435 436 437 438 439 440 441 442 443 444
	446 447 448 449 450 451 452 453 454 
}
south_astios = { 
	256 257 258 259 260 261 262 263 264 265
	266 267 268 269 270 271 272 273 274 275
	276 277 278 279 280 281 282 283 284 285
	286 287 288 289 293 294 295 241 242 243
	290 291 292 296 297 298 299 300 301 302
	228 229 230 231 233 235 236 237 238 239
	244 245 246 247 248 249 250 251 252 253
	254 255 2028 240 234 232 
}
katsura = { 
	725 726 727 728 729 730 731 732 733 736
	737 738 739 740 741 742 743 744 745 746
	747 748 749 750 751 752 753 754 755 756
	757 758 759 760 761 762 4202 4203 4206 4207
	4208 4218 4219 4220 4221 4222 4223 4665 4666 4667
	4668 4669 4670 4671 4672 4673 4674 4675 4676 4677
	4678 4679 4680 4681 4682 4683 4684 902 903 904
	905 906 907 908 909 910 911 912 913 914
	915 916 917 918 919 920 4200 4201 4214 4215
	4216 4217 4652 4653 4654 4658 4659 4660 4661 4662
	4663 4664 765 764 763 735 734 766 767 768
	769 770 771 772 773 774 775 776 777 778
	779 780 781 782 783 
}
elaresh = { 
	653 654 655 656 657 658 659 660 661 662
	663 664 665 666 667 668 669 670 671 672
	673 674 675 676 677 678 679 680 681 682
	683 4270 4271 4288 4291 4292 4297 4298 2697 2698
	2699 2701 2703 2704 2705 2706 2707 2708 2709 2710
	2711 2712 2713 2714 2715 2716 2717 2718 2719 2720
	2721 2722 2723 2724 2726 2727 2728 2954 4561 4562
	4563 4564 4566 4567 4568 615 616 617 618 619
	620 621 622 623 624 625 626 627 628 629
	630 631 632 633 634 635 636 637 638 639
	640 641 642 643 644 645 646 647 648 649
	650 651 652 3003 4295 4296 4307 4308 4309 4310
	4311 4312 4313 4314 4315 4700 2669 2729 2730 2731
	2732 2733 2734 2735 2736 2737 2738 2739 2740 2741
	2742 2743 2744 2745 2746 2747 2748 2749 2750 2751
	2752 2753 2754 2755 2756 2757 2758 2759 2760 2761
	2762 2763 2764 2999 4171 4289 4290 4293 4294 4300
	4304 4327 4329 4330 4331 4332 4335 4337 4338 4339
	4341 4342 4345 1273 1318 1951 1952 1953 1954 2437
	2438 2439 2440 2441 2442 2443 2444 2445 2446 2448
	2449 2450 2451 2452 2453 2454 2455 2456 2457 2458
	2459 2460 2461 2462 2463 2464 2465 2466 2467 2468
	2469 2470 2471 2472 2473 2474 2475 2476 2477 2478
	2479 2480 2481 2482 2483 2484 2485 2486 2487 2488
	2489 2490 2491 2492 2493 2494 2495 2496 2497 2498
	2499 2500 2501 2502 2503 2504 2505 2506 2998 4125
	4126 4127 4128 4236 4240 4529 4530 4531 4532 2447
	2507 2508 2509 2510 2511 2512 2586 2587 2588 2589
	2590 2591 2592 2593 2595 2596 2597 2598 2599 2600
	2601 2602 2603 2604 2605 2606 2607 2608 2609 2610
	2611 2612 2613 2614 2615 2616 2617 2618 2619 2620
	4324 4325 4326 4334 4336 2646 2647 2648 2649 2650
	2651 2652 2653 2654 2655 2656 2657 2658 2659 2660
	2661 2662 2663 2664 2665 2666 2667 2668 2670 2671
	2672 2673 2674 2675 2676 2677 2678 2679 2680 2681
	2682 2683 2684 2685 2686 2687 2688 2689 2690 2691
	2692 2693 2694 2695 2696 2700 2702 2725 4316 4317
	4318 4319 4320 4323 2594 
}
phormyrr = { 
	1008 1009 1010 1011 1012 1013 1014 1015 1016 1017
	1018 1019 1020 1021 1022 1023 1024 1025 1026 1027
	1028 1029 1030 1031 1032 1033 1034 1035 1036 1037
	1038 1039 1040 1041 1042 1043 1044 1045 1046 1047
	1048 1049 1050 1051 1052 1053 1054 1055 4871 4872
	4873 4874 4875 4876 4912 1097 1098 1099 1100 1101
	1102 1103 1104 1105 1106 1107 1108 1109 1110 1111
	1112 1113 1114 1115 1116 1117 1118 1119 1120 1121
	1122 1123 1124 1125 1126 1127 1128 1129 1130 4890
	4891 4892 4893 4894 4895 4896 4897 1131 1132 1133
	1134 1135 1136 1137 1138 1139 1140 1141 1142 1143
	1144 1145 1146 1147 1148 1149 1150 1151 1152 1153
	1154 1155 1156 1157 1158 1159 1160 1161 1162 1163
	1164 1165 1166 1167 1168 1169 1170 1171 1172 1173
	1174 1175 1176 4625 4626 4877 4878 4879 4880 4881
	4882 1056 1057 1058 1059 1060 1061 1062 1063 1064
	1065 1066 1067 1068 1069 1070 1071 1072 1073 1074
	1075 1076 1077 1078 1079 1080 1081 1082 1083 1084
	1085 1086 1087 1088 1089 1090 1091 1092 1093 1094
	1095 1096 2525 4898 4899 4903 4904 4907 4922 983
	984 985 986 987 988 989 990 991 992 993
	994 995 996 997 998 999 1000 1001 1002 1003
	1004 1005 1006 1007 4197 949 950 951 952 953
	954 955 956 957 958 959 960 961 962 963
	964 965 966 967 968 969 970 971 972 973
	974 975 976 977 978 979 980 981 982 921
	922 923 924 925 926 927 928 929 930 931
	932 933 934 935 936 937 938 939 940 941
	942 943 944 945 946 947 948 4194 4195 4196
	4198 784 785 786 787 788 789 790 791 792
	793 794 795 796 797 798 799 800 801 802
	803 804 805 806 807 808 809 810 811 812
	813 814 815 816 817 818 900 4887 4888 4889
	4906 4913 4921 855 856 857 858 859 860 861
	862 863 864 865 866 867 868 869 870 871
	872 873 874 875 876 877 878 879 880 881
	882 883 884 885 886 887 888 889 890 891
	892 893 894 895 896 897 898 899 901 2766
	2832 2833 2834 2835 2836 2837 2838 2839 2840 2841
	2842 2854 2878 2882 2883 2940 2941 2942 2946 819
	820 821 822 823 824 825 826 827 828 829
	830 831 832 833 834 835 836 837 838 839
	840 841 842 843 844 845 846 847 848 849
	850 851 852 853 854 2803 2804 2805 2806 2807
	2808 2809 2810 2811 2812 2813 2814 2815 2816 2817
	2818 2819 2931 2937 2939 4595 4596 4599 4600 4601
	4602 4603 4604 4605 4607 4608 4609 4610 4611 4612
	4613 4614 4615 4616 4617 1793 1794 1795 1796 1797
	1798 1799 1800 1801 1802 1803 1804 1805 1806 1807
	1808 1809 1810 1811 1812 1813 1814 1815 1816 1817
	1818 4790 4791 4792 4793 4794 4799 4800 4801 4802
	4803 4804 4805 4806 1819 1820 1821 1822 1823 1824
	1825 1826 1827 1828 1829 1830 1831 1832 1833 1834
	1835 1836 1837 1838 1839 1840 1841 1842 1843 4809
	4810 4811 4812 4813 4814 4815 4816 4817 4818 4835
	1232 1233 1234 1235 1236 1237 1238 1239 1240 1241
	1242 1243 1244 1245 1246 1247 1248 1249 1742 1743
	1744 1745 1746 1747 1748 1749 1750 1751 1752 1753
	1754 1755 4348 4349 4350 4351 4352 4353 4354 4355
	4356 4795 4796 4797 4798 4845 1177 1178 1179 1180
	1181 1182 1183 1184 1185 1186 1187 1188 1189 1190
	1191 1192 1193 1194 1195 1196 1197 1198 1199 1200
	1201 1202 1203 1204 1205 1206 1207 1208 1209 1210
	1211 1212 1213 1214 1215 1216 1217 1218 1219 1220
	1221 1222 1223 1224 1225 1226 1227 1228 1229 1230
	1231 4819 4820 4821 4822 4823 4824 4825 4826 4827
	4828 4829 4830 4831 4832 4833 4834 4836 4837 4838
	4839 4840 4841 4842 1756 1757 1758 1759 1760 1761
	1762 1763 1764 1765 1766 1767 1768 1769 1770 1771
	1772 1773 1774 1775 1776 1777 1778 1779 1780 1781
	1782 1783 1784 1785 1786 1787 1788 1789 1790 1791
	1792 4934 4935 4936 4937 4938 4939 
}
onthukan = { 
	525 546 547 548 549 550 551 552 553 554
	555 556 557 558 559 560 1947 4407 4408 4409
	4412 4414 4415 4416 4417 4418 4419 4420 4425 526
	527 528 529 530 531 532 533 534 535 536
	537 538 539 540 541 542 543 544 545 4393
	4394 4395 4396 4397 4398 4399 4404 4405 4406 303
	304 305 306 307 308 309 310 311 312 313
	314 315 316 317 318 319 4227 4228 4229 4230
	4231 4232 320 321 322 323 324 325 326 327
	328 329 330 331 455 456 457 458 459 460
	461 462 463 464 465 466 467 468 469 470
	471 472 473 474 475 476 477 478 479 480
	4204 4205 4481 4482 4514 4515 4516 4517 4518 4519
	4520 498 499 500 501 502 503 504 505 506
	507 508 509 510 511 512 513 514 515 516
	4440 4441 4445 4446 4447 4448 4450 4451 4452 4470
	4471 4473 4474 4475 4476 4477 4478 4479 4486 481
	482 483 484 485 486 487 488 489 490 491
	492 493 494 495 496 497 517 518 519 520
	521 522 523 524 4411 4449 4459 4463 4464 4465
	4466 4467 4468 4469 4472 4483 4484 4485 4487 4488
	4489 4490 4491 4492 4493 4494 4495 4496 4497 4498
	4499 4508 4509 4510 4511 4513 4521 
}
